12222223---------122222222222223---------------------------
10000003---------100000000000003---------------------------
10000003---------100000G00000003---------------------------
10000003---------100000000000003---------------------------
10000003---------100000000000003---------------------------
100P0003---------100000000000003---------------------------
10000003---------100000000000003---------------------------
74450068---------744444445006448---------------------------
---1003------------------1003------------------------------
---1003------------------1003-----1222222222222222222222223
12220022222222222222222222002223--1000000000000000000000003
10000000000000000000000000000003--1000000000000000000000003
1000000000000000000000000000000222200000000000000000000X003
10000000000000000000000000000000000000000000000000000000003
10000000S00000000000000000000000000000000000000000000000003
10000000000000000000G000000000064450000000S0000000000000003
10000000000000000000000000000003--1000000000000000000000003
10000000000000000000000000000003--7444444444444444444444448
10000000000000000000000000000003---------------------------
10000000000000000000000000000003---------------------------
74444444444444444500644444444448---------------------------
-----------------1003--------------------------------------
-----------------1003--------------------------------------
-----------------100222222222223---------------------------
-----------------100000000000003---------------------------
-----------------100000000000003---------------------------
-----------------100000000000003---------------------------
-----------------1000G0000000003---------------------------
-----------------100000000000003---------------------------
-----------------100000000000003---------------------------
-----------------744444444444448---------------------------

